1 0 0 0 0 0 0 1 1 1 0 6 2 
5 0 0 0 1 0 0 0 0 0 0 0 2 
3 0 0 0 0 1 0 1 0 0 1 0 2 
0 0 0 0 0 0 0 0 0 0 0 0 2 
0 0 0 0 0 1 1 1 1 0 0 4 2 
0 0 0 0 0 0 0 7 0 0 0 8 2