1 1 1 1 1 1 1 1 1 1 1 1 2
1 0 0 0 0 0 0 0 0 0 0 1 2
1 0 0 0 0 0 0 0 0 0 0 1 2
1 0 0 0 0 0 0 0 0 0 0 1 2
1 3 5 7 0 1 1 0 8 6 4 1 2
1 1 1 1 1 1 1 1 1 1 1 1 2