7 1 1 1 1 0 0 0 1 1 1 0 2 
0 0 0 0 0 0 1 0 0 0 0 8 2 
0 0 0 0 0 0 0 0 1 0 0 0 2 
0 0 0 1 1 0 0 0 0 0 0 6 2 
0 0 0 0 0 0 1 0 0 0 0 4 2 
5 1 1 0 0 0 0 3 0 1 1 0 2