0 0 0 0 0 6 0 0 1 1 1 0 2 
0 0 0 0 0 0 0 0 0 0 5 0 2 
0 0 0 0 1 8 1 0 0 0 0 1 2 
0 0 0 0 0 3 0 0 0 1 1 1 2 
0 1 1 1 1 0 0 0 0 0 0 1 2 
7 1 4 0 0 0 1 0 1 1 1 1 2