1 4 1 1 1 8 0 1 1 1 1 1 2
1 0 6 0 1 1 0 1 1 1 1 1 2
1 0 1 0 1 1 0 1 1 1 1 1 2
1 0 0 0 0 0 0 0 0 0 7 1 2
1 3 1 1 1 0 1 0 1 1 1 1 2
1 1 1 1 1 0 0 5 1 1 1 1 2